汤惠休=tang hui xiu
董华丽=dong hua li
郭健华=guo jian hua
史宏达=shi hong da
王诗卉=wang shi hui
杨腊香=yang la xiang
鄢福生=yan fu sheng
宋士奎=song shi kui
吴子章=wu zi zhang
高民政=gao min zheng
林嘉慧=lin jia hui
王仙芳=wang xian fang
武彬=wu bin
董俊华=dong jun hua
舒冬梅=shu dong mei
顾方方=gu fang fang
段宏俊=duan hong jun
黄斯琪=huang si qi
刘青荣=liu qing rong
魏雯霞=wei wen xia
王卫光=wang wei guang
许凤山=xu feng shan
麻寅生=ma yin sheng
党权=dang quan
陈大柱=chen da zhu
孙保营=sun bao ying
沙洪涛=sha hong tao
穆琳琳=mu lin lin
董慕云=dong mu yun
陈旭楠=chen xu nan
林淑平=lin shu ping
姜贝=jiang bei
樊辉辉=fan hui hui
孟会=meng hui
田贞见=tian zhen jian
罗庆富=luo qing fu
蔡晓微=cai xiao wei
徐志森=xu zhi sen
叶巧蕊=ye qiao rui
曹玉德=cao yu de
金景花=jin jing hua
樊翠霞=fan cui xia
刘辉兵=liu hui bing
柯铭峰=ke ming feng
曲东阳=qu dong yang
尚永锋=shang yong feng
耿奕=geng yi
郭雪风=guo xue feng
刘持平=liu chi ping
陈安芬=chen an fen
王树来=wang shu lai
叶敏洁=ye min jie
白维维=bai wei wei
李开彬=li kai bin
巫玉华=wu yu hua
康朝锋=kang chao feng
杨春娇=yang chun jiao
褚胜男=chu sheng nan
韩太平=han tai ping
苏会敏=su hui min
李来寿=li lai shou
狄剑=di jian
高伟凯=gao wei kai
刘思言=liu si yan
陆子艺=lu zi yi
贾玉卓=jia yu zhuo
焦森=jiao sen
吴春容=wu chun rong
雷琼珍=lei qiong zhen
孟祥江=meng xiang jiang
温泉铭=wen quan ming
雅迅=ya xun
夏尚=xia shang
王琴波=wang qin bo
李天初=li tian chu
肖桂杰=xiao gui jie
苑彬=yuan bin
杨心=yang xin
吴达海=wu da hai
何文元=he wen yuan
尚学辉=shang xue hui
宋雪光=song xue guang
柯茗=ke ming
郭建俊=guo jian jun
袁继鹏=yuan ji peng
罗练=luo lian
龚文胜=gong wen sheng
吴艳妮=wu yan ni
黄锡鸿=huang xi hong
吕延杰=lu yan jie
王广风=wang guang feng
陈定宇=chen ding yu
蒋开文=jiang kai wen
顾芳芳=gu fang fang
俞燕华=yu yan hua
唐少林=tang shao lin
洪文胜=hong wen sheng
余海兵=yu hai bing
高晨=gao chen
艾宏=ai hong
俞长峰=yu zhang feng
