刘持平=liu chi ping
洪文胜=hong wen sheng
樊辉辉=fan hui hui
苏会敏=su hui min
高民政=gao min zheng
曹玉德=cao yu de
袁继鹏=yuan ji peng
舒冬梅=shu dong mei
杨腊香=yang la xiang
许凤山=xu feng shan
王广风=wang guang feng
黄锡鸿=huang xi hong
罗庆富=luo qing fu
顾芳芳=gu fang fang
顾方方=gu fang fang
宋雪光=song xue guang
王诗卉=wang shi hui
苑彬=yuan bin
徐志森=xu zhi sen
沙洪涛=sha hong tao
郭健华=guo jian hua
巫玉华=wu yu hua
耿奕=geng yi
高伟凯=gao wei kai
叶敏洁=ye min jie
尚学辉=shang xue hui
王仙芳=wang xian fang
吴达海=wu da hai
林嘉慧=lin jia hui
郭建俊=guo jian jun
刘思言=liu si yan
蔡晓微=cai xiao wei
柯茗=ke ming
吕延杰=lu yan jie
蒋开文=jiang kai wen
陈大柱=chen da zhu
唐少林=tang shao lin
陈定宇=chen ding yu
刘辉兵=liu hui bing
叶巧蕊=ye qiao rui
艾宏=ai hong
金景花=jin jing hua
杨心=yang xin
雅迅=ya xun
俞燕华=yu yan hua
姜贝=jiang bei
樊翠霞=fan cui xia
陆子艺=lu zi yi
董俊华=dong jun hua
郭雪风=guo xue feng
吴春容=wu chun rong
余海兵=yu hai bing
尚永锋=shang yong feng
麻寅生=ma yin sheng
焦森=jiao sen
康朝锋=kang chao feng
狄剑=di jian
党权=dang quan
孙保营=sun bao ying
曲东阳=qu dong yang
刘青荣=liu qing rong
孟祥江=meng xiang jiang
陈安芬=chen an fen
李天初=li tian chu
褚胜男=chu sheng nan
陈旭楠=chen xu nan
董慕云=dong mu yun
穆琳琳=mu lin lin
王琴波=wang qin bo
魏雯霞=wei wen xia
肖桂杰=xiao gui jie
汤惠休=tang hui xiu
王卫光=wang wei guang
吴子章=wu zi zhang
王树来=wang shu lai
韩太平=han tai ping
宋士奎=song shi kui
夏尚=xia shang
林淑平=lin shu ping
孟会=meng hui
吴艳妮=wu yan ni
董华丽=dong hua li
杨春娇=yang chun jiao
龚文胜=gong wen sheng
柯铭峰=ke ming feng
贾玉卓=jia yu zhuo
雷琼珍=lei qiong zhen
俞长峰=yu zhang feng
武彬=wu bin
田贞见=tian zhen jian
李开彬=li kai bin
高晨=gao chen
李来寿=li lai shou
温泉铭=wen quan ming
黄斯琪=huang si qi
段宏俊=duan hong jun
鄢福生=yan fu sheng
史宏达=shi hong da
罗练=luo lian
何文元=he wen yuan
白维维=bai wei wei
